++++++++++++++++++++++++++++++++++++++++++++++++++++++++++++++++++++++++++++++++++++++++++++++++++++++++++++++++++++++++++++++++
+..............................................................................................................................+
+.                                                                                                                            .+
+.                                                                                                                            .+
+.  ++++++++++++++++++++++++++++++++++++++++++++++++++++++++++++++++++++++++++++++++++++++++++++++++++++++++++++++++++++++++  .+
+.  +......................................................................................................................+  .+
+.  +...#...#..###..####.....................................................................=....===......=...=...====....+  .+
+.  +...##.##.#...#.#...#...................................................................==...=...=....=...==.......=...+  .+
+.  +...#.#.#.#...#.#...#....................................................................=.......=...=.....=.......=...+  .+
+.  +...#.#.#.#####.####.....................................................................=......=....=.....=....===....+  .+
+.  +...#...#.#...#.#........................................................................=.....=....=......=.......=...+  .+
+.  +...#...#.#...#.#........................................................................=....=....=.......=.......=...+  .+
+.  +...#...#.#...#.#.......................................................................===..=====........===..====....+  .+
+.  +......................................................................................................................+  .+
+.  ++++++++++++++++++++++++++++++++++++++++++++++++++++++++++++++++++++++++++++++++++++++++++++++++++++++++++++++++++++++++  .+
+.                                                                                                                            .+
+.                                                                                                                            .+
+.                                                                                                                            .+
+.                                                                                                                            .+
+.                                                                                                                            .+
+.      ++++++++++++++++++++++++++++++++++++++++++++++++++++++++++++++++++++++++++++++++++++++++++++++++++++++++++++++++      .+
+.      +          ?                 ?                 ?                 ?                 ?                 ?         +      .+
+.      +          ?                 ?                 ?                 ?                 ?                 ?         +      .+
+.      +          ?                 ?                 ?                 ?                 ?                 ?         +      .+
+.      +          ?                 ?                 ? #               ?                 ?                 ?         +      .+
+.      +          ?                 ?                 ?###              ?                 ?                 ?         +      .+
+.      +          ?                 ?                 ? #*              ?                 ?                 ?         +      .+
+.      +          ?                 ?                 ?  *              ?                 ?                 ?         +      .+
+.      +??????????????????????????????????????????????????*???????????????????????????????????????????????????????????+      .+
+.      +          ?                 ?                 ?    *            ?                 ?                 ?         +      .+
+.      +          ?                 ?                 ?    *            ?                 ?                 ?         +      .+
+.      +          ?                 ?                 ?     *#####      ?                 ?                 ?         +      .+
+.      +          ?                 ?                 ?     #     #     ?                 ?                 ?         +      .+
+.      +          ?                 ?                 ?    # *     #    ?                 ?                 ?         +      .+
+.      +          ?                 ?                 ?   #   ###   #   ?                 ?                 ?         +      .+
+.      +          ?                 ?                 ?   #  #####  #   ?                 ?                 ?         +      .+
+.      +          ?                 ?                 ?   #  #####  #   ?                 ?                 ?         +      .+
+.      +          ?                 ?                 ?   #  #####* #   ?                 ?                 ?         +      .+
+.      +          ?                 ?                 ?   #   ###  *#*  ?                 ?                 ?         +      .+
+.      +          ?                 ?                 ?    #       #  **?#                ?                 ?         +      .+
+.      +          ?                 ?                 ?     #     #     ###               ?                 ?         +      .+
+.      +?????????????????????????????????????????????????????#####?????**#????????????????????????????????????????????+      .+
+.      +          ?                 ?                 ?              ** ?                 ?                 ?         +      .+
+.      +          ?                 ?                 ?            **   ?                 ?                 ?         +      .+
+.      +          ?                 ?                 ?          **     ?                 ?                 ?         +      .+
+.      +          ?                 ?                 ?        **       ?                 ?                 ?         +      .+
+.      +          ?                 ?                 ?  #   **         ?                 ?                 ?         +      .+
+.      +          ?                 ?                 ? ###**           ?                 ?                 ?         +      .+
+.      +          ?                 ?                 ?  #*             ?                 ?                 ?         +      .+
+.      +          ?                 ?                 ?                 ?                 ?                 ?         +      .+
+.      +          ?                 ?                 ?                 ?                 ?                 ?         +      .+
+.      ++++++++++++++++++++++++++++++++++++++++++++++++++++++++++++++++++++++++++++++++++++++++++++++++++++++++++++++++      .+
+.                                                                                                                            .+
+.                                                                                                                            .+
+.                                                                                                                            .+
+.                                                                                                                            .+
+.                                                                                                                            .+
+.                                                                                                                            .+
+.                                                                                                                            .+
+.                                                                                                                            .+
+.                                                                                                                            .+
+.                                                                                                                            .+
+..............................................................................................................................+
++++++++++++++++++++++++++++++++++++++++++++++++++++++++++++++++++++++++++++++++++++++++++++++++++++++++++++++++++++++++++++++++
