++++++++++++++++++++++++++++++++++++++++++++++++++++++++++++++++++++++++++++++++++++++++++++++++++++++++++++++++++++++++++++??++
+.............................................................................................................................??
+.                                                                                                                            .+
+.                                                                                                                            .+
+.  ++++++++++++++++++++++++++++++++++++++++++++++++++++++++++++++++++++++++++++++++++++++++++++++++++++++++++++++++++++++++  .+
+.  +......................................................................................................................+  .+
+.  +...#...#..###..####...........................................................................=....===......=.........+  .+
+.  +...##.##.#...#.#...#.........................................................................==...=...=....=..........+  .+
+.  +...#.#.#.#...#.#...#..........................................................................=.......=...=...........+  .+
+.  +...#.#.#.#####.####...........................................................................=......=....=...........+  .+
+.  +...#...#.#...#.#..............................................................................=.....=....=............+  .+
+.  +...#...#.#...#.#..............................................................................=....=....=.....=.=.=...+  .+
+.  +...#...#.#...#.#.............................................................................===..=====.......=.=.=...+  .+
+.  +++++++++++++++++++++++++++++++++++++++++++++++++++++++++++!!!++++++++++++++++++++++++++++++++++++++++++++++++++++++++++  .+
+.                                                            !!!!!                                                           .+
+.                                                            !!!!!                                                           .+
+.                                                            !!!!!                                                           .+
+.                                                             !!!                                                            .+
+.    +++++++++++++++++++++++++++++++++++++++++++++++++++++++++!!!++++++++++++++++++++++++++++++++++++++++++++++++++++++++    .+
+.    +        ?               ?               ?               ! !             ?               ?               ?         +    .+
+.    +        ?               ?               ?              !?  !            ?               ?               ?         +    .+
+.    +        ?               ?               ?             ! ?***!           ?               ?               ?         +    .+
+.    +        ?               ?               ?               ?    ********   ?               ?          #####?         +    .+
+.    +        ?               ?               ?               ?            *******            ?         # #   #         +    .+
+.    +        ?               ?               ?               ?               ?   ********    ?        #  ##  ?#        +    .+
+.    +????????????????????????????????????????????????????????????????????????????????????*******?????###########???????+    .+
+.    +        ?               ?               ?               ?               ?               ?  *****#*####### #       +    .+
+.    +        ?               ?               ?               ?               ?               ?       #  *##****#       +    .+
+.    +        ?               ?               ?               ?               ?               ?       #   #   ? #****** +    .+
+.    +        ?               ?               ?               ?               ?               ?       #  #    ? #      ********
+.    +        ?               ?               ?               ?               ?               ?        ##     ?#        +    .+
+.    +        ?               ?               ?               ?               ?               ?        ##     #         +    .+
+.    +        ?               ?               ?               ?               ?               ?          #####?         +    .+
+.    +        ?               ?               ?               ?               ?               ?               ?         +    .+
+.    +        ?               ?               ?               ?               ?               ?               ?         +    .+
+.    +        ?               ?               ?               ?               ?               ?               ?         +    .+
+.    +        ?               ?               ?               ?               ?               ?               ?         +    .+
+.    +??????????????????????????????????????????????????????????????????????????????????????????????????????????????????+    .+
+.    +        ?               ?               ?               ?               ?               ?               ?         +    .+
+.    +        ?               ?               ?               ?               ?               ?               ?         +    .+
+.    +        ?               ?               ?               ?               ?               ?               ?         +    .+
+.    +        ?               ?               ?               ?               ?               ?               ?         +    .+
+.    +        ?               ?               ?               ?               ?               ?               ?         +    .+
+.    +        ?               ?               ?               ?               ?               ?               ?         +    .+
+.    +        ?               ?               ?               ?               ?               ?               ?         +    .+
+.    +        ?               ?               ?               ?               ?               ?               ?         +    .+
+.    +        ?               ?               ?               ?               ?               ?               ?         +    .+
+.    +        ?               ?               ?               ?               ?               ?               ?         +    .+
+.    +        ?               ?               ?               ?               ?               ?               ?         +    .+
+.    +??????????????????????????????????????????????????????????????????????????????????????????????????????????????????+    .+
+.    +        ?               ?               ?               ?               ?               ?               ?         +    .+
+.    +        ?               ?               ?               ?               ?               ?               ?         +    .+
+.    +    =====  ===   ===  = ? =  ====      ===      ====  ===== =   =  ==== ?    ===      =====  ===   ===  =   =     +    .+
+.    +    =   ? =   = =   = = ? = =         = ? =     =   =   =   ==  = =     ?   =   =       ? = =   = =   = == ==     +    .+
+.    +    =   ? =   = =     = ? = =           ?=      =   =   =   = = = =     ?      =        ?=  =   = =   = = = =     +    .+
+.    +    ====? =   = =     = ? =  ===        =       ====    =   =  ==  ===  ?     =         =   =   = =   = = = =     +    .+
+.    +    =   ? =   = =     = ? =     =       =       =       =   =   =     = ?     =        =?   =   = =   = =   =     +    .+
+.    +++++=+++++=+++=+=+++=+=+++=+++++=+++++++++++++++=+++++++=+++=+++=+++++=+++++++++++++++=+++++=+++=+=+++=+=+++=++++++    .+
+.         =      ===   ===   ===  ====        =       =     ===== =   = ====        =       =====  ===   ===  =   =          .+
+.                                                                                                                            .+
+.                                                                                                                            .+
+.                                                                                                                            .+
+..............................................................................................................................+
++++++++++++++++++++++++++++++++++++++++++++++++++++++++++++++++++++++++++++++++++++++++++++++++++++++++++++++++++++++++++++++++
